####E#####
#........#
#...s....#
#@.#\o.x.#
#.b......#
#.o.....o#
#e/...own#
##########
