####E###
#......#
#..x...#
#......#
#..b...#
#......#
#...@..#
#......#
########
