#######################
#@....................#
#..####..#...#..####..#
#.#......##..#..#...#.#
#.####...#.#.#..#...#.#
#.#......#..##..#...#.#
#..####..#...#..####..#
#.....................E
#######################
