##########
#.\...o..#
#........#
#x.b.....#
#........#
#.n......#
#....@...#
########E#
