####E###
#....s.#
#......#
#......#
#.@....#
#....\.#
#e.....#
##...oo#
########
