####E###
###...##
#x@b..##
###.bx##
#x##b.##
#.#xx.##
#b.bbbx#
#...x..#
########
